111111
1a0101
101001
1101N1
111111