111111
105501
101001
1101N1
111111