1111111
1100011
1000001
101N001
1000001
1000001
1111111