1111111
1100011
100001
101N001
1000001
1000001
1111111