000011
100101
101001
1101N1
111111