1111111111111111111111
1100000000000000000011
1000000000000000000001
1000000000000000N00001
1000000000000000000001
1000000000000000000001
1111111111111111111111