NO ./textures/NorthXL.xpm
SO ./textures/SouthXL.xpm
WE ./textures/WestXL.xpm
EA ./textures/EastXL.xpm

F 100,100,200
C 180,180,0


1111111111111111111111
1100000000000000000011
1000000000000000000001
1000000000000010N00001
1000000000000000000001
1000000000000000000001
1111111111111111111111
