111111
100001
101001
1101N1
111111