NO ./textures/NorthXL.xpm
SO ./textures/SouthXL.xpm
WE ./textures/WestXL.xpm
EA ./textures/EastXL.xpm

F 220,250,1
C 200,8,1

11111111111111111111111111111111
1000000000100000000000001
1011000001100000000000001
1001000000000000N0000001111111
1111111110110001011100000000001
1000000000110000011101111111111
11110111111111011100000010001
11110111111111011101010010001
11000000110101011100000010001
10000000000000001100000010001
10000000000000001101010010001
11000001110101011111011110001
11110111111101011101101010001
11111111111111111111111111111