NO ./textures/NorthXL.xpm
SO ./textures/SouthXL.xpm
WE ./textures/WestXL.xpm
EA ./textures/EastXL.xpm

F 100,100,100
C 225,200,0

111 1
10111
101S1
11111
