NO ./textures/NorthXL.xpm
SO ./textures/SouthXL.xpm
WE ./textures/WestXL.xpm
EA ./textures/EastXL.xpm

F 100,100,100
C 225,200,0

     111           1111111111111111111111
     1S1           1000000000000000000001
     1S1           1011111111111111111101
     101           1000000010001000000101
     101           1011111110101000000101
111111011111111    1010000000101000000101
100000000000001    1010000000101000000101
111111111111101    1010111110101111111101
100000000000101    1010000010100000000101
101111111111101    1010111010111111110101
100000000000001    1010101010000000010101      111111111111111111
111111111111101    1010101010011111010101      100000000000000001
            10111111110101010010001010101111111101111111111111101
            10000000000101010010101010100000000000000000001   101
            11111111111101010010101010101111111101111111111   101
                     10101011110101010101      101            101
                     10101000000100010101      101            101
                     10001111111111110001      101            101
                     11111          11111      111            111