SO ./textures/SouthXL.xpm
NO ./textures/NorthXL.xpm
EA ./textures/EastXL.xpm
WE ./textures/WestXL.xpm

C 180,180,sfd
F 0,0,0


1111       11111111111111
1001       10000000000001
1001111111110100000000001
1001000000000000000000001
11111111101100000111S00001
10000000001100000111011111111
11110111111111011100000010001
11110111111111011101010010001
11001000110101011100000010001
1001 100000000001100000010001
10001000000000001101010010001
11000001110101011111011110001
11110111 1110101 101111010001
111111111   11111111111111111