NO ./textures/North.xpm
SO ./textures/South.xpm
WE ./textures/West.xpm
EA ./textures/East.xpm

F 220,250,1
C 200,8,11

1111111111111111111111111111111111
1000000000100000000000001
1011000001100000000000001
100100000000000000000000111111111
11111111101100000111000000000001
1000000000110000011101111111111
11110111111111011100000010001
11110111111111011101010010001
11000000110101011100000010001
1000000000000000110000S010001
10000000000000001101010010001
11000001110101011111011110001
11110111111101011101111010001
11111111111111111111111111111